NO textures/wall.xpm
EA     textures/wall.xpm
SO textures/wall.xpm
WE textures/wall.xpm
F 0,0,0
C  135,206,250

1111111111111111111111111
1000000000110000000000001
1011000001110000000000X01
100100000000000000000000111111111
1111111110110000011100N000000001
100000000011000001110111111111111
11110111111111011100000010001
11110111111111011101010010001
11000000110101011100000010001
10000000000000001100000010001
10000000000000001101010000001
1100000111010101111101111000111
11110111 1110101 101111010001
11111111 1111111 111111111111