NO test.xpm
EA     test.xpm
SO test.xpm
WE test.xpm
F 0,0,0
C 255,255,255


111   111
 100001
10000        1
100001
1 000N1
111111
