NO test.xpm
EA     test.xpm
SO test.xpm
WE test.xpm
F 0,0,0
C 255,255,255

111111111
100011101
101000001
1N0010001
111111111
