NO textures/wall.xpm
EA     textures/wall.xpm
SO textures/wall.xpm
WE textures/wall.xpm
F 0,0,0
C  135,206,250

11111
10001
10101
10001
1N001
11111
