NO             textures/wall.xpm
EA     textures/wall.xpm

SO textures/wall.xpm
WE textures/wall.xpm



F textures/wall.xpm
C 177,239,   255
D textures/door.xpm



    1111111111111111111111111111
        1111000000000000100011111
       11011000001110000100000001
11111111001000000100X00011D110011
1000000100000000110000X0110001111
1000000D00000000110101XXD0001
11000001110101011111011110N011
11111111 1111111 111111111111