NO test.xpm
EA     test.xpm
SO test.xpm
WE test.xpm
F 0,0,0
C 255,255,255

1111
1001
1001
1N01
1111
